NO ./textures/eagle.xpm
SO ./textures/greystone.xpm
WE ./textures/purplestone.xpm
EA ./textures/red.xpm

F 25,10,255
C 225,30,0

        1111111111111111111111111
        1000000000110000000000001
        1001000001110000000000001
        10010000000000000W0000001
111111111001000001110000000000001
100000000011000001110111111111111
11110111111111011100000000001
11110111111111011101010010001
11000000110101011100000010001
10000000000000000000000010001
10000000000000001101010010001
11000001100001111101111000111
11110111 1110101 101111010001
11111111 1111111 111111111111