
NO ./textures/eagle.xpm
SO ./textures/greystone.xpm
WE ./textures/purplestone.xpm
EA ./textures/red.xpm

F 250,20,100
C 135,206,235
        

        1111111111111111111111111
        1000000000110000000000001
        1011000001110000000000001
        1001000000000000000000001
111111111011000001110000000000001
100000000011000001111101111111111
1111011111111101110000001000101
111101111111110111010100100011
11000000110101011100000000001
100000000000000000000000111101
10000000000000001101010000101
11000001101010111110110000E11
11110111 1110101 10111100001
11111111 1111111 111111111111